000000000000000000000000000000000000000011101111111111111111010011100000000000000000000000000000000000000000000000000000
000000000000000000000000000000000000000011101111111111111111010011100000000000000111000000000000000000000000000000000000
000000000000000000000000000000000000000000001111111111111111010000000000000000000111000000000000111111000000000000000000
000000000000000000000000000000000000000000001111111111111111010000000000000000000000000000000000111111000000000000000000
000000000000000000000000000000000000000000000000000000000000000000000000000000000000000000000011111111110000000000000000
000000000000000000000000000000000000000000000000000000000000000000000000000000000000000000000011111111110000000000000000
111111111111110000000000000000000000000000000000000000000000000000000000000000000000000000000011111111110001110000000000
111111111111110000000000000000000000000000001111111111111111010000000000000000000000000000000011111111110001110000000000
111111111111110000000000000000000000000011101111111111111111010011100000000000000000000000000000111111000001110000000000
111111111111110000000000000000000000000011101111111111111111010011100000000000000000000000000000111111000000000000000000
111111111111110000000000000000000000000000111111111111111111010000000000000000000000000000000000000000000000000000000000
111111111111110000000000000000000000000000111111111111111111010000000000000000000000000000000000000000000000000000000000
111111111111110000000000000000000000000000111111111111111111010000000000000000000000000000000000000000000000000000000000
000000000000000000000000000000000000000000111111111111111111011111100000000000000000000000000000000000000000000000000000
000000000000000000000000000000000000000000111111111111111111011111100000000000000000000000000000000000000111111111111111
000000000000000000000000000000000000000000111111111111111111000001100000000000000000000000000000000000000111111111111111
000000000000000000000000000000000000000000111111111111111111000001100000000000000000000000000000000000000111111111111111
000000000000000000000000000000000000000000111111111111110000000001100000000000000000000000000000000000000111111111111111
000000000000000000000000000000000000000000111111111111110000000001100001110000000000000000000000000000000111000000000000
000000000000000000000000000000000000000000111111111111110000000001100001110000000000000000000000000000000111000000000000
000000000000000000000000000000000000000000111111111111110000000001100001110000000000000000000000000000000111000000000000
000000000000000000000000000001111100000111111111111111110000000001100000000000000000000000000000000000000111000000000000
000000000000000000000000000001111100000111111111111111110000000001100000000000000000000000000000000000000111000000000000
000000000000000000000111111111000000000000011111111111110000000001100000000000000000000000000000000000000111000000000000
000000000000000000000111111111000000000000011111111111110000000001100000000000000000000000000000000000000111000000000000
000000000000000111111100000000000000000000011111111111110000000001111111111111111111100000000000000000000111000000000000
000000000000000111111100000000000000000000011111111111110000000001111111111111111111100000000001110000000111000000000000
000000000111111100000000000000000000000000011111111111110000000000000000000000000001100000000001110000000111000000000000
000000000111111100000000000000000000000000011111111111110000000000000000000000000001100000000001110000000111111111111111
000111111100000000000000000000000000000000011111111111000000000000000000000000000001100000000000000000000111111111111111
000111111100000000000000000000000000000000011111111111000000000000000000000000000001100000000000000000000111111111221111
111100000000000000000000000000000000000001111111111111000000000000000000000000000001100000000000000000000000000000000000
111100000000000000000000000000000000000001111111111111000000000000000000000000000001100000000000000000000000000000000000
000000000000000000000000000000000000000001111111111111000000000000000000000000000001100000000000000000000000000000000000
000000000000000000000000000000000000000001111111111111000000000000000000000000000001100000000000000000000000000000000000
000000000000000000000000000000000000000001111111111111000000000000000000000000000001100000000000000000000000000000000000
000000000000000000000000000000000000000001111111111111000000000000000000000000000001100000000000000000000000000000000000
000000000000000000000000000000000000000001111111111111000000000111000000000000000001100000000000000000000000000000000000
111111111111111111111000000000000000000001111111111111000000000111000000000000000001100000000000000000000000000000000000
111111111111111111111000000000000000000001111111111100000000000000000000000000000001100000000000000000000000000000000000
111111111111111111111111100011111111000001111111111100000000000000000000000000000001100000000000000000000000000000000000
111111111111111111111111100011111111000001111111111100000000000000000000000000000001100000000000000000000000000000000000
111111111111111111111111100011111111111111111111111100000000000000000000000000000001100000011100000000000000000000000000
111111111111111111111111100011111111111111111111111100000000000000000000000000000001111000011100000000000000000000000000
111111111111111111111111100011111111111111111111111100000000000000000000000000000001111000011100000000000000000000000000
111111111111111111111111100011111111111111111111111100000000000000000000000000000000011000000000000000000000000000000000
111111111111111111111111100011111111111111111111111111000000000000000000000000000000011000000000000000000000000000000000
111111111111111111111111100011111111111111111111111111000000000000000000000000000000011110000000000000000000000000000000
111111111111111111111111100011111111111111111111111111110000000000000000000000000000011110000000000000000000000000000000
111111111111111111110000000000000111111111111111111111111100000000000000000000000000000011111111111111110000011111111111
111111111111111111110000000000000111111111111111111111111100000000000000000000000000000011111111111111110000011111111111
111111111111111100000000000000000111111111111111111111111111000000000000000000000000000000000000000000000000000000000000
111111111111111100000000000000000111111111111111111111111111000000000000000000000000000000000000000000000000000000000000
111111111111111100000000000000000111111111111111111111111111000000000000000000000000000000000000000000000000000000000000
111111111111111100000000000000000111111111111111111111111111000000000000000000000000000000000000000000000000000000000000
111111111111111101110000000000000111111111111111111111111111000000000000000000000000000000000000000000000000000000000000
111111111111111101110000000000000111111111111111111111111111110000000000000000000000000000000000000000000000000000000000
111111111111111100000000000000000111111111111111111111111111110000000000000000000000000000000000000000000000000000000000
111111111111111100000000000000000111111111111111111111111111110000000000000000000000000000000000000000000000000000000000
111111111111111100000000000000000111111111111111111111111111110000000000000000000000000000000000000000000000000000000000
111111111111111111110000000000000111111111111111111111111111111100000000000000000000000000000000000000000001110000000000
111111111111111111110000000000000111111111111111111111111111111100000000000000000000000000000000000000000001110000000000
111111111111111111111111111111111111111111111111111111111111111100000000000000000000000000000000000000000001110000000000
111111111111111111111111111111111111111111111111111111111111111100000000000000000000000000000000000000000000000000000000
111111111111111111111111111111111111111111111111111111111111111111000000000000000000000000000000000000000000000000000000
111111111111111111111111111111111111111111111111111111111111111111000000000000000000000000000000000000000000000000000000
111111111111111111111111111111111111111111111111111111111111111111110000000000000000000000000000000000000000000000000000
111111111111111111111111111111111111111111111111111111111111111111111111111111111111111111111111111111111111111111111111
